14 x 9
000 000 000 000 000 000 096 000 000 000 096 000 000 000
000 000 096 016 016 016 016 016 016 016 016 016 000 000
096 000 000 016 000 000 000 096 000 000 000 016 000 000
000 000 000 016 000 000 016 016 016 016 000 016 096 000
000 096 000 016 096 000 016 146 017 016 096 016 000 000
000 000 000 016 000 000 016 000 000 016 000 016 000 000
000 000 000 016 000 000 016 000 000 016 000 016 000 000
000 000 051 016 000 096 000 096 000 016 000 000 000 096
018 000 000 096 000 000 000 000 000 016 000 000 000 000
