14 x 14
051 000 146 000 016 016 016 016 016 016 000 000 000 000
000 000 000 016 032 037 032 032 037 032 016 016 000 000
000 016 037 032 037 032 037 037 032 037 032 037 016 000
000 016 032 037 032 037 032 032 037 032 037 032 016 000
016 032 037 016 016 016 037 037 016 016 016 037 032 016
016 037 016 016 016 016 032 032 016 016 016 016 037 016
016 032 016 016 016 016 037 037 016 016 064 037 032 016
016 037 032 016 016 037 032 032 037 016 016 032 037 016
000 016 037 032 037 032 037 037 032 037 032 037 016 000
000 000 016 037 032 037 016 016 037 032 037 016 000 000
000 000 000 016 037 032 016 016 032 037 016 000 000 000
000 000 000 016 032 037 032 032 037 032 016 000 000 000
000 000 000 016 039 016 037 037 016 037 016 000 000 000
000 000 000 000 016 016 016 016 016 016 000 000 000 000
