12 x 12
000 000 000 000 146 000 016 017 000 032 036 039
000 000 000 000 000 000 016 017 000 035 000 033
000 000 000 000 000 000 016 000 000 000 000 000
017 017 000 000 000 000 016 000 000 000 000 000
017 000 096 000 000 000 016 000 000 000 000 000
017 000 000 000 000 000 016 000 000 000 017 000
000 000 000 000 032 036 016 000 000 000 000 000
000 000 000 000 000 000 016 000 000 052 000 000
000 000 000 000 000 000 000 016 000 000 000 000
000 000 000 000 000 000 000 000 016 000 000 000
000 051 000 000 000 000 096 000 000 016 016 016
000 000 000 000 000 000 000 000 000 000 000 039
