14 x 10
146 017 016 000 051 000 000 000 000 000 000 017 017 017
000 000 016 000 000 000 000 000 000 000 000 000 000 037
000 000 016 016 016 016 016 016 016 016 016 016 000 000
000 000 016 000 000 000 000 000 000 000 000 016 000 000
000 000 016 000 016 000 016 016 016 016 000 016 000 000
000 000 000 000 016 000 016 000 000 000 000 016 000 000
000 000 016 016 016 000 016 000 016 016 016 016 000 000
000 000 016 038 000 000 016 000 000 051 000 016 000 000
000 000 016 016 016 016 016 016 016 016 016 016 000 000
017 000 000 000 000 000 000 000 000 000 000 000 000 033
