11 x 11
000 000 000 000 000 000 000 000 000 016 000
016 016 016 016 000 000 000 000 000 000 000
000 000 000 000 000 000 000 000 000 016 038
000 000 096 000 000 000 000 000 000 016 016
000 000 000 000 017 017 017 000 000 000 000
000 000 000 000 017 064 017 000 000 000 000
036 000 000 000 017 037 017 000 000 000 000
034 000 000 000 000 000 000 000 000 000 000
000 000 000 000 000 000 000 000 096 000 000
016 016 016 016 016 000 000 000 000 000 017
000 146 000 000 000 000 000 000 000 000 000
