15 x 10
017 017 000 000 000 000 000 000 000 000 000 000 000 000 000
000 000 096 000 000 000 000 016 016 016 016 016 016 000 051
000 000 000 000 000 096 000 000 000 000 000 000 016 016 016
036 035 000 000 000 000 000 000 000 000 000 000 000 000 000
016 016 016 016 016 016 016 016 016 016 000 000 096 000 000
000 000 000 000 000 000 000 000 038 016 000 000 000 000 000
000 017 017 017 000 000 096 000 000 016 096 000 000 000 000
000 017 146 017 000 000 096 000 000 000 000 000 000 000 000
000 017 000 017 000 000 000 096 000 000 000 000 000 037 017
000 000 000 000 000 000 000 000 000 000 000 000 032 039 017
