15 x 13
000 000 016 016 016 016 000 000 000 016 016 016 016 000 000
000 016 000 000 000 000 016 000 016 000 000 000 000 016 000
016 000 000 000 000 000 000 016 000 000 000 000 000 000 016
016 000 000 000 000 000 000 000 000 000 000 000 000 000 016
016 000 000 086 000 000 000 051 000 000 000 086 000 000 016
016 000 000 000 000 000 000 000 000 000 000 000 000 000 016
000 016 000 000 000 000 000 000 000 000 000 000 000 016 000
000 000 016 000 000 000 000 000 000 000 000 000 016 000 000
000 000 000 016 000 000 000 018 000 000 000 016 000 000 000
000 000 000 000 016 000 000 000 000 000 016 000 000 000 000
000 000 000 000 000 016 000 000 000 016 000 000 000 000 000
000 000 000 000 000 000 016 000 016 000 000 000 000 000 000
000 000 000 000 000 000 000 016 000 000 000 000 000 000 000 
