11 x 11
0 0 0 0 0 0 0 0 0 16 0 
16 16 16 16 0 0 0 0 0 0 0 
0 0 0 0 0 0 0 0 0 16 38 
0 0 0 0 0 0 0 0 0 16 16 
0 0 0 0 17 17 17 0 0 0 0 
98 0 0 0 17 0 17 0 0 0 0 
36 0 0 0 17 96 17 0 0 0 0 
34 0 0 0 0 0 0 0 0 0 0 
0 0 0 0 0 0 0 0 0 0 0 
16 16 16 16 16 0 0 0 0 96 17 
0 50 0 0 0 0 0 0 0 0 0 
