14 x 9
0 0 0 0 0 0 96 0 0 0 96 0 0 0 
0 0 96 16 16 16 16 16 16 16 16 16 0 0 
96 0 0 16 0 0 0 96 0 0 0 16 0 0 
0 0 0 16 0 0 16 16 16 16 0 16 96 0 
0 96 0 16 96 0 16 146 17 16 96 16 0 0 
0 0 0 16 0 0 16 0 0 16 0 16 0 0 
0 0 0 16 0 0 16 0 0 16 0 16 0 0 
0 0 51 16 0 96 0 96 0 16 0 0 0 96 
18 0 0 96 0 0 0 0 0 16 0 0 0 0 
