14 x 14
51 0 146 0 16 16 16 16 16 16 0 0 0 0 
0 0 0 16 32 37 32 32 37 32 16 16 0 0 
0 16 37 32 37 32 37 37 32 37 32 37 16 0 
0 16 32 37 32 37 32 32 37 32 37 32 16 0 
16 32 37 16 16 16 37 37 16 16 16 37 32 16 
16 37 16 16 16 16 32 32 16 16 16 16 37 16 
16 32 16 16 16 16 37 37 16 16 64 37 32 16 
16 37 32 16 16 37 32 32 37 16 16 32 37 16 
0 16 37 32 37 32 37 37 32 37 32 37 16 0 
0 0 16 37 32 37 16 16 37 32 37 16 0 0 
0 0 0 16 37 32 16 16 32 37 16 0 0 0 
0 0 0 16 32 37 32 32 37 32 16 0 0 0 
0 0 0 16 39 16 37 37 16 37 16 0 0 0 
0 0 0 0 16 16 16 16 16 16 0 0 0 0 
