14 x 10
146 17 16 0 51 0 0 0 0 0 0 17 17 17 
0 0 16 0 0 0 0 0 0 0 0 0 0 37 
0 0 16 16 16 16 16 16 16 16 16 16 0 0 
0 0 16 0 0 0 0 0 0 0 0 16 0 0 
0 0 16 0 16 0 16 16 16 16 0 16 0 0 
0 0 0 0 16 0 16 0 0 0 0 16 0 0 
0 0 16 16 16 0 16 0 16 16 16 16 0 0 
0 0 16 38 0 0 16 0 0 51 0 16 0 0 
0 0 16 16 16 16 16 16 16 16 16 16 0 0 
17 0 0 0 0 0 0 0 0 0 0 0 0 33 
