15 x 10
17 17 0 0 0 0 0 0 0 0 0 0 0 0 0 
0 0 96 0 0 0 0 16 16 16 16 16 16 0 51 
0 0 0 0 0 96 0 0 0 0 0 0 16 16 16 
36 35 0 0 0 0 0 0 0 0 0 0 0 0 0 
16 16 16 16 16 16 16 16 16 16 0 0 96 0 0 
0 0 0 0 0 0 0 0 38 16 0 0 0 0 0 
0 17 17 17 0 0 96 0 0 16 96 0 0 0 0 
0 17 146 17 0 0 96 0 0 0 0 0 0 0 0 
0 17 0 17 0 0 0 96 0 0 0 0 0 37 17 
0 0 0 0 0 0 0 0 0 0 0 0 32 39 17 
