15 x 13
0 0 16 16 16 16 0 0 0 16 16 16 16 0 0 
0 16 0 0 0 0 16 0 16 0 0 0 0 16 0 
16 0 0 0 0 0 0 16 0 0 0 0 0 0 16 
16 0 0 0 0 0 0 0 0 0 0 0 0 0 16 
16 0 0 86 0 0 0 51 0 0 0 86 0 0 16 
16 0 0 0 0 0 0 0 0 0 0 0 0 0 16 
0 16 0 0 0 0 0 0 0 0 0 0 0 16 0 
0 0 16 0 0 0 0 0 0 0 0 0 16 0 0 
0 0 0 16 0 0 0 18 0 0 0 16 0 0 0 
0 0 0 0 16 0 0 0 0 0 16 0 0 0 0 
0 0 0 0 0 16 0 0 0 16 0 0 0 0 0 
0 0 0 0 0 0 16 0 16 0 0 0 0 0 0 
0 0 0 0 0 0 0 16 0 0 0 0 0 0 0 
