12 x 12
0 0 0 0 146 0 16 17 0 32 36 39 
0 0 0 0 0 0 16 17 0 35 0 33 
0 0 0 0 0 0 16 0 0 0 0 0 
17 17 0 99 0 0 16 0 0 0 0 0 
17 0 0 0 0 0 16 0 0 0 0 0 
17 0 0 0 0 0 16 0 0 0 17 0 
0 0 0 0 32 36 16 0 0 0 0 0 
0 0 0 0 0 0 16 0 0 52 0 0 
0 0 0 0 0 0 0 16 0 0 0 0 
0 0 0 0 0 0 0 0 16 0 0 0 
0 51 0 0 0 0 99 0 0 16 16 16 
0 0 0 0 0 0 0 0 0 0 0 39 
